                              +----+      
                              |    |      
                              |    ########
                              |    |      #
                              +-#--+      #
                                #         #
                    +--+        #         #
  ###################  ##########         #
  #                 |  |        #         #
  #                 +--+        #         #
  #                      +------#-----+   #
  #                      |            |   #
  #    +---------+       |            #####
  #    |         |       |            |   #
  #    |         |  ######            #####
  ######         |  #    |            |   #
       |         ####    |            #####
       |         |       |            |    
       +---#-----+       +------#-----+   
           #                    ###       
           #                      #       
           #                   ####       
   #########                   #          
   #             +---+         ########   
   #             |   |                #   
   #        ######   |                #   
+--#--+     #    |   |   ##############   
|     |     #    |   |   #                
|     #######    |   |   #                
|     |          |   +---#--+             
+-----+          |          |             
                 +----------+             
